2 2 2 2 2 2 2 2 2 2 2 2 2 2 2 2
2 0 0 0 0 0 0 0 0 0 0 0 0 0 0 2
2 0 0 0 0 0 0 0 0 0 0 0 0 0 0 2
2 0 2 0 0 0 0 0 0 0 0 0 0 0 0 2
2 0 2 2 2 2 2 2 2 2 2 2 2 2 0 2
2 0 0 0 0 0 0 0 0 0 0 0 0 0 0 2
2 0 0 0 0 0 0 0 0 0 0 0 0 0 0 2
2 0 2 2 2 2 2 2 2 2 2 2 2 2 0 2
2 0 0 0 0 0 0 0 0 0 0 0 0 2 0 2
2 0 0 0 0 0 0 0 0 0 0 0 0 0 0 2
2 0 0 0 0 0 0 0 0 0 0 0 0 0 0 0
2 2 2 2 2 2 2 2 2 2 2 2 2 2 2 2

// 2 as a Wall
// 0 as a Floor1
// 3 as a Door